#Fri Sep 21 13:32:18 EDT 2018
viewsettings=Einstellungen
CatalogID=Katalog-ID
mailingstreet=Mailingstraße
Google\ temporary\ Token=Google temporäres Token
Enabled=Aktiviert
Password=Passwort
mailingcity=Mailingstadt
Failed\ login\ attempts=Fehlgeschlagene Anmeldeversuche
Username=Benutzername
Access\ Token\ expiry\ time=Zugriffs-Token-Ablaufzeit
Name=Name
openadmintoolbar=openadmintoolbar
orderingcost=Bestellkosten
Access\ Token\ Time=Zugriffs-Token-Zeit
Email=E-Mail
productlegal=Produktlegal
mailingzip=Mailing-Zip
mobilephone=Mobiltelefon
uploadpermission=Upload-Erlaubnis
productzones=Produktzonen
showdebug=showdebug
Sent\ By=Gesendet von
defaultcolor=Standardfarbe
Job\ Title=Berufsbezeichnung
productspecialrestrictions=Produktspezifische Einschränkungen
photooptions=Fotooptionen
productvpa=Produktvpa
User\ Search=Benutzersuche
User\ ID=Benutzer-ID
officezip=Bürozip
productavailability=Produktverfügbarkeit
Last\ Name=Nachname
ldap_postfix=ldap_postfix
EnterMedia\ Key=entermedia Schlüssel
mailingstate=Versandstatus
All\ Fields=alle Felder
officecity=Bürostadt
birthdate=Geburtsdatum
resultstype=Ergebnistyp
virtual=virtuell
ldapserver=ldapserver
lastname=Familienname, Nachname
assistant=Assistent
Notes=Notizen
productorderingoptions=Produktbestellungsoptionen
companyname=Name der Firma
datalevel=Datenebene
id=Ich würde
productexpirations=Produktabläufe
Groups=Gruppen
Screen\ Name=Künstlername
officestate=Amtsstaat
mailingcountry=Sendeland
First\ Name=Vorname
Enable\ HTML\ editing=ermöglichen HTML-Bearbeitung
officestreet=Bürogebäude
showfilter=showfilter
oe_edit_mode=oe_edit_mode
productreviewers=Produktkritiker
Google\ Refresh\ Token=Google-Aktualisierungswertmarke
Google\ Client\ ID=Google Client-ID
retention=Zurückhaltung
firstname=Vorname
officephone=Bürotelefon
Core\ Search\ Type=Schlüsselsuchtyp
officecountry=Bürolandschaft
resulttype=Ergebnistyp
ldap_prefix=ldap_prefix

